Gilbert Perreault,F,1191,512,814,1326,41,2010-2014
Dave Andreychuk,F,837,368,436,804,22,1999-2009
Rick Martin,F,681,382,313,695,12,1994-1995
Craig Ramsay,F,1070,252,420,672,324,2021-2022
Phil Housley,D,608,178,380,558,3,1970-1972
Rene Robert,F,524,222,330,552,47,1986-1990
Don Luce,F,766,216,310,526,214,1985-1989
Jason Pominville,F,733,217,304,521,20,1970-1971
Mike Foligno,F,664,247,264,511,115,1982-2001
Danny Gare,F,503,267,233,500,187,2017-2018
Thomas Vanek,F,598,254,243,497,29,2014-2015
Miroslav Satan,F,578,224,232,456,44,1986-1990
Alexander Mogilny,F,381,211,233,444,44,2019-2022
Derek Roy,F,549,161,266,427,39,1993-1996
Pat Lafontaine,F,268,158,227,385,3,1970-1974
Dale Hawerchuk,F,342,110,275,385,-29,1989-2001
Ric Seiling,F,664,176,200,376,116,2016-2017
Jack Eichel,F,375,139,216,355,-69,2015-2018
Jochen Hecht,F,613,138,207,345,67,1970-1972
Maxim Afinogenov,F,569,134,200,334,-26,2016-2018
Jim Lorentz,F,487,134,197,331,-6,1992-1999
Christian Ruuttu,F,438,101,230,331,16,1998-2003
Mike Ramsey,D,911,73,256,329,166,1983-1989
Pierre Turgeon,F,322,122,201,323,13,1970-1972
Drew Stafford,F,563,145,177,322,-20,2002-2004
Tim Connolly,F,464,94,226,320,-2,2017-2019
Andre Savard,F,467,130,175,305,67,2014-2015
Donald Audette,F,421,166,131,297,-6,2018-2019
Sam Reinhart,F,454,134,161,295,-97,2007-2008
Alexei Zhitnik,D,712,55,234,289,-33,2021-2022
Doug Bodger,D,479,54,233,287,15,1995-2007
Lindy Ruff,F,608,102,183,285,3,2020-2022
Jerry Korab,D,537,67,216,283,78,1993-1994
John Tucker,F,345,116,154,270,2,1995-1996
Tony McKegney,F,363,127,141,268,39,1988-1996
Curtis Brown,F,542,109,143,252,76,2014-2020
Rasmus Ristolainen,D,542,46,199,245,-163,1978-1979
Bill Hajt,D,854,42,202,244,320,2018-2021
Ales Kotalik,F,426,114,126,240,-24,2002-2004
Tyler Ennis,F,419,97,139,236,-65,1992-1995
Derek Plante,F,395,91,145,236,21,1995-1998
Daniel Briere,F,225,92,138,230,14,2000-2004
Jim Schoenfeld,D,584,45,183,228,230,2010-2012
Jean-Pierre Dumont,F,362,102,121,223,-33,1975-1979
Mike Peca,F,363,96,121,217,50,2011-2013
John Van Boxmeer,D,294,49,166,215,70,2002-2007
Gerry Meehan,F,306,94,114,208,-44,1973-1976
Gilles Hamel,F,365,92,114,206,-28,2003-2004
Paul Cyr,F,343,85,111,196,-29,1994-2004
Kyle Okposo,F,369,76,114,190,-67,1990-1993
Chris Drury,F,234,85,104,189,-2,1986-1987
Richard Smehlik,D,589,47,135,182,67,2020-2022
Paul Gaustad,F,479,71,110,181,14,2016-2017
Ryan OReilly,F,224,65,111,176,-40,1995-1998
Brian Campbell,D,391,32,144,176,-7,1972-1974
Stu Barnes,F,310,67,105,172,-11,2021-2022
Jocelyn Guevremont,D,324,38,130,168,143,2008-2011
Brian Holzinger,F,352,70,97,167,-6,1971-1972
Jason Woolley,D,365,40,125,165,31,2010-2011
Rick Dudley,F,279,70,94,164,57,2020-2022
Derek Smith,F,244,65,98,163,38,1999-2008
Michal Grosek,F,308,62,98,160,67,2006-2007
Jason Dawe,F,290,79,79,158,11,1991-1994
Brad May,F,425,67,89,156,-10,2016-2017
Zemgus Girgensons,F,532,71,83,154,-59,1972-1978
Tyler Myers,D,365,45,106,151,-31,2015-2016
Yuri Khmylev,F,254,63,87,150,15,1991-1993
Rasmus Dahlin,D,264,27,123,150,-74,1981-1989
Jeff Skinner,F,261,88,60,148,-42,1983-1985
Dmitri Kalinin,D,466,34,111,145,11,2015-2016
V�clav Varada,F,376,46,98,144,12,2013-2014
Scott Arniel,F,295,64,74,138,21,2006-2007
Rick Vaive,F,189,74,62,136,25,1995-1996
Dixon Ward,F,307,56,80,136,38,2001-2011
Richie Dunn,D,327,27,105,132,36,1989-2002
Chris Gratton,F,244,50,81,131,-4,2020-2022
Matthew Barnaby,F,317,47,79,126,11,1983-1989
Hannu Virta,D,245,25,101,126,16,2017-2018
Matt Moulson,F,297,46,77,123,-37,1970-1976
Evander Kane,F,196,68,50,118,-45,1980-1999
Randy Wood,F,236,60,57,117,8,1990-1992
Marcus Foligno,F,347,49,67,116,-17,1982-1988
Henrik Tallinder,D,532,22,94,116,25,2013-2014
Fred Stanfield,F,248,42,73,115,4,2014-2015
Ray Sheppard,F,159,64,50,114,-10,2018-2022
Brian Spencer,F,240,42,72,114,27,1970-1971
Victor Olofsson,F,175,50,63,113,-42,2014-2015
Benoit Hogue,F,196,45,67,112,-10,2020-2021
Sean McKenna,F,237,56,53,109,-14,1982-1986
Peter McNab,F,154,49,59,108,28,1993-1998
Brent Peterson,F,265,43,63,106,28,2019-2021
Adam Mair,F,498,35,70,105,-10,1970-1973
Toni Lydman,D,371,14,91,105,30,1989-1990
Brian Gionta,F,230,40,63,103,-29,2021-2022
Uwe Krupp,D,327,25,78,103,19,2003-2004
Garry Galley,D,163,15,87,102,12,1974-1978
Adam Creighton,F,172,40,60,100,-2,2013-2017
Larry Playfair,D,577,24,76,100,2,1974-1975
Cody Hodgson,F,218,44,55,99,-65,1991-1994
Randy Burridge,F,159,39,60,99,17,1987-1990
Dale McCourt,F,119,41,57,98,-14,1991-1993
Jaroslav Spacek,D,205,22,76,98,29,2003-2007
Jay McKee,D,582,17,81,98,45,1970-1974
Johan Larsson,F,392,38,59,97,-41,1972-1981
Steve Atkinson,F,255,49,47,96,-24,1970-1972
Andrej Sekera,D,339,17,75,92,6,2000-2006
Rob Ray,F,889,40,50,90,-38,1977-1989
Doug Smith,F,162,35,54,89,-27,1985-1988
Grant Ledyard,D,240,18,71,89,10,2020-2022
Christian Ehrhoff,D,192,16,71,87,-23,1981-1982
Teppo Numminen,D,212,6,80,86,19,1976-1982
Gary McAdam,F,227,40,45,85,12,2011-2014
Phil Goyette,F,97,18,67,85,-26,2015-2021
Bob Sweeney,F,185,37,44,81,-1,2018-2019
Wayne Presley,F,202,48,32,80,30,1988-1989
Taylor Pyatt,F,230,38,42,80,-12,2008-2015
Tage Thompson,F,169,45,34,79,-41,1985-1986
Clarke MacArthur,F,187,41,38,79,-11,2009-2017
Erik Rasmussen,F,281,33,46,79,8,2009-2015
Dave Hannan,F,249,23,56,79,24,1992-1993
Ken Sutton,D,232,18,60,78,-4,2001-2002
Lee Fogolin,D,338,8,70,78,28,1971-1972
Daniel Paille,F,195,35,42,77,20,2016-2018
Jake McCabe,D,353,18,59,77,-28,1972-1975
Alan Haworth,F,106,37,38,75,-1,2015-2018
James Patrick,D,345,23,51,74,40,2016-2018
Casey Mittelstadt,F,182,30,43,73,-45,1982-1987
Jean-Francois Sauve,F,98,24,49,73,5,1986-1989
Nathan Gerbe,F,188,29,43,72,14,2011-2012
Dave Snuggerud,F,215,26,46,72,-8,1981-1983
Evan Rodrigues,F,192,26,45,71,-30,2021-2022
Mike Grier,F,241,23,47,70,-1,2001-2006
Darryl Shannon,D,255,12,56,68,87,1970-1971
Eddie Shack,F,111,36,31,67,-39,2012-2015
Jordan Leopold,D,174,25,42,67,-13,2020-2021
Zach Bogosian,D,243,13,54,67,-49,1974-1987
Geoff Sanderson,F,168,29,36,65,18,2011-2017
Yvon Lambert,F,77,25,39,64,22,1981-1991
Al Hamilton,D,145,6,58,64,-34,1990-1992
Jacques Richard,F,155,24,38,62,8,2015-2017
Mike Hartman,F,225,34,26,60,-12,2019-2020
Real Cloutier,F,82,24,36,60,-4,1992-1995
Mark Napier,F,128,26,30,56,-11,2006-2008
Steve Patrick,F,152,21,34,55,4,1985-1992
Doug Gilmour,F,82,10,45,55,6,1994-1997
Calle Johansson,D,118,6,49,55,5,1985-1986
Patrick Kaleta,F,348,27,27,54,-18,1974-1982
Mike Robitaille,D,170,8,46,54,0,2002-2012
Petr Svoboda,D,139,5,49,54,1,2008-2013
Conor Sheary,F,133,23,30,53,-22,1986-1988
Mike Weber,D,341,9,44,53,-42,1982-1983
Larry Carriere,D,206,9,43,52,14,1999-2001
Mal Davis,F,89,29,22,51,-8,2019-2020
Ken Priestlay,F,117,25,25,50,-10,2014-2017
Don Marshall,F,62,20,29,49,-13,2013-2022
Steve Montador,D,151,10,39,49,16,1992-1995
Dylan Cozens,F,107,16,32,48,-29,2014-2018
Ville Leino,F,137,10,36,46,-18,1971-1980
Wayne Primeau,F,225,19,25,44,-9,1970-1972
Gates Orlando,F,98,18,26,44,-9,2007-2012
Steve Ott,F,107,18,26,44,-23,1998-2000
Marco Scandella,D,176,14,30,44,-19,2016-2017
Kevin Maguire,F,167,18,25,43,5,1999-2003
Terry Martin,F,148,20,22,42,-12,1972-1975
Brandon Montour,D,112,13,29,42,-4,2003-2011
Rhett Warrener,D,266,9,33,42,47,2017-2018
Nathan Paetsch,D,157,7,35,42,17,2012-2015
Craig Rivet,D,165,4,38,42,-7,1995-2000
Matt Ellis,F,286,18,23,41,-22,1989-1990
Brian Flynn,F,159,17,24,41,-7,1974-1979
Larry Hillman,D,121,6,35,41,-24,2016-2019
Tracy Pratt,D,210,2,39,41,0,2013-2015
Mike Moller,F,127,13,27,40,1,2021-2022
Tony Tanti,F,80,16,23,39,-2,1985-1987
Norm Gratton,F,103,15,23,38,-7,1973-1987
Hugh Harris,F,60,12,26,38,8,1984-1989
Henri Jokiharju,D,162,10,28,38,-19,2020-2021
Wilf Paiement,F,56,20,17,37,3,1989-1992
Rasmus Asplund,F,124,14,23,37,-14,1999-2003
Brad Boyes,F,86,13,24,37,4,1980-1986
Colin Miller,D,135,7,30,37,-30,1970-1972
Mark Pysyk,D,189,7,30,37,-21,1991-1996
Mikael Andersson,F,99,4,33,37,3,1972-1973
Cody Franson,D,127,7,29,36,-10,1981-1982
Chris Butler,D,155,5,31,36,4,1986-1991
Jeff Parker,F,137,16,19,35,-7,1992-2001
Larry Mickey,F,117,20,14,34,0,1990-1995
Clark Gillies,F,86,15,19,34,1,1980-1982
Mike Wilson,D,231,11,23,34,49,2021-2022
Doug Barrie,D,102,6,28,34,-40,2002-2013
Vladimir Tsyplakov,F,70,13,20,33,19,2002-2003
Cody McCormick,F,201,11,22,33,-24,2000-2001
Paul Andrea,F,47,11,21,32,-15,1980-1982
Shawn Anderson,D,113,6,26,32,5,1991-1992
Ron Anderson,F,111,14,16,30,-22,1971-1973
Normand Lacombe,F,94,12,18,30,-6,2021-2022
Nick Deslauriers,F,211,12,18,30,-54,2011-2015
Alex Tuch,F,37,9,21,30,4,1985-1987
Marcus Johansson,F,60,9,21,30,-12,1987-1992
Kevin Haller,D,81,7,23,30,-4,1998-2000
Larry Keenan,F,65,9,20,29,-14,1994-2000
David Fenyves,D,148,2,27,29,7,1972-1974
Steve Dykstra,D,128,5,23,28,-9,1987-1988
Jamie McGinn,F,63,14,13,27,-10,1994-2003
Craig Simpson,F,46,12,15,27,-8,1990-1993
Mike Donnelly,F,74,11,16,27,-6,2020-2022
Luke Adam,F,87,15,11,26,-11,1982-1990
John Gould,F,92,14,12,26,2,1994-1997
Tim Kennedy,F,79,10,16,26,-3,1995-1996
Dean Kennedy,D,144,6,20,26,-7,1985-1986
Josh Gorges,D,223,3,23,26,-42,2018-2019
Chris Stewart,F,66,11,14,25,-32,1997-2000
Jim Wiemer,D,74,8,17,25,-3,2018-2021
Randy Moller,D,126,5,20,25,2,1970-1971
Darrin Shannon,F,55,10,14,24,-6,1978-1979
Dick Duff,F,61,9,15,24,-20,2020-2021
Rory Fitzpatrick,D,157,9,15,24,-32,1995-1996
Chris Evans,D,61,6,18,24,-20,1987-1988
Vince Hinostroza,F,49,11,12,23,-8,1981-1982
Kevin OShea,F,93,10,13,23,-30,2002-2006
Philippe Boucher,D,65,7,16,23,6,2021-2022
Tom Kurvers,D,55,6,17,23,-13,1995-1996
Mark Astley,D,75,4,19,23,-15,2003-2006
Tim Horton,D,124,1,22,23,15,1987-1989
Mikko M�kel�,F,60,15,7,22,-2,2019-2021
Denis Hamel,F,130,13,9,22,-8,2019-2020
Bob Mongrain,F,70,11,11,22,2,2015-2018
Vyacheslav Kozlov,F,38,9,13,22,0,2019-2022
Rob McClanahan,F,66,5,17,22,-11,2017-2018
Dave Maloney,D,52,1,21,22,20,1998-1999
Paul Terbenche,D,121,2,19,21,-7,1984-1985
Jimmy Vesey,F,64,9,11,20,12,1988-1989
Chris Taylor,F,90,8,12,20,-4,2019-2020
Bill Stewart,D,81,3,17,20,5,2006-2015
Craig Muni,D,160,2,18,20,12,1999-2008
Benoit Pouliot,F,74,13,6,19,-8,2015-2018
Curtis Lazar,F,71,10,9,19,-7,2015-2016
Bob Corkum,F,106,10,9,19,-12,2011-2012
Scott Wilson,F,70,7,12,19,-24,1970-1972
Rob Niedermayer,F,71,5,14,19,-8,1989-1991
Jim Watson,D,144,4,15,19,-61,2008-2010
Taylor Hall,F,37,2,17,19,-21,1992-1996
Colin Patterson,F,88,8,10,18,-6,2013-2014
Randy Wyrozub,F,100,8,10,18,-13,2013-2014
Cody Eakin,F,110,7,11,18,-21,1973-1985
Floyd Smith,F,83,6,12,18,-16,1986-1987
Casey Nelson,D,93,4,14,18,-15,2001-2009
Joe Reekie,D,104,3,15,18,7,1976-1978
Jacob Bryson,D,98,2,16,18,-7,2001-2002
Doug Rombough,F,51,8,9,17,5,1970-1971
Peyton Krebs,F,35,7,10,17,-12,2021-2022
Jamie McBain,D,69,6,11,17,-13,2002-2003
Eric Boulton,F,172,5,12,17,-3,1986-1992
Tom Barrasso,G,266,0,17,17,,1997-2000
Danny Lawson,F,78,10,6,16,-22,2016-2017
Mike Byers,F,46,9,7,16,-20,1986-1987
Jir� Novotn�,F,64,8,8,16,-7,1970-1971
Charlie Huddy,D,85,7,9,16,-7,1984-1987
Reg Fleming,F,78,6,10,16,-8,1991-1997
Vladimir Sobotka,F,85,6,10,16,-18,1970-1971
Gord Donnelly,F,134,5,11,16,-1,2008-2011
Nikita Zadorov,D,67,4,12,16,-14,1981-1982
Nathan Beaulieu,D,89,4,12,16,-18,1983-1986
Bob Halkidis,D,89,2,14,16,6,1989-1990
Bob Logan,F,38,10,5,15,6,2013-2020
Brent Hughes,F,76,5,10,15,-9,1971-1972
Jay Wells,D,85,3,12,15,-20,2019-2021
Marc-Andre Gragnani,D,59,2,13,15,10,1988-1993
Andrej Meszaros,D,60,7,7,14,-13,2015-2016
Torrey Mitchell,F,60,7,7,14,-6,2015-2018
Alexander Sulzer,D,57,6,8,14,2,2011-2014
Mikhail Grigorenko,F,68,6,8,14,-14,1973-1974
David Legwand,F,79,5,9,14,-4,2010-2013
Jim Korn,F,52,4,10,14,-3,1985-1987
Ken Breitenbach,D,68,1,13,14,7,2013-2014
Daren Puppa,G,215,0,14,14,,2014-2015
Don Lever,F,39,10,3,13,-8,1990-1992
Michael Ryan,F,65,7,6,13,-12,1989-1992
Pat Hughes,F,50,4,9,13,-5,1986-1988
Keith Carney,D,51,4,9,13,-1,1971-1978
Riley Sheahan,F,53,4,9,13,-8,1971-1981
Mark Mancari,F,36,3,10,13,-3,1987-1989
Bob Boughner,D,177,2,11,13,20,1989-1990
Dominik Hasek,G,491,0,13,13,,2020-2022
Anders Bjork,F,66,7,5,12,-19,2005-2010
Steve Heinze,F,14,5,7,12,6,2006-2010
Cliff Schmautz,F,26,5,7,12,-11,1992-1995
Matt DAgostini,F,49,5,6,11,-14,2021-2022
Bill Houlder,D,32,4,7,11,1,2011-2012
Viktor Gordiouk,F,26,3,8,11,1,1987-1990
Don Edwards,G,307,0,11,11,,2002-2010
Arttu Ruotsalainen,F,35,7,3,10,-10,2014-2015
Nicholas Baptiste,F,47,7,3,10,-3,1990-1991
Randy Cunneyworth,F,35,4,6,10,-2,1988-1992
Kevin Porter,F,43,4,6,10,-6,2016-2017
Eric Staal,F,32,3,7,10,-20,1984-1985
Milan Bartovic,F,26,2,8,10,1,2006-2011
Justin Falk,D,98,1,9,10,-19,1970-1971
Viktor Antipin,D,47,0,10,10,-9,1971-1981
Dane Jackson,F,22,5,4,9,3,1975-1979
Phil Varone,F,42,5,4,9,-16,1991-1998
Skip Krake,F,74,4,5,9,-21,1975-1983
Steve Bernier,F,17,3,6,9,1,2013-2014
Corey Tropp,F,43,3,6,9,-8,2013-2021
Jan Ludvig,F,26,1,8,9,0,1979-1981
Andre Benoit,D,59,1,8,9,-19,2009-2015
Bob Sauve,G,246,0,9,9,,1981-1984
Ryan Miller,G,540,0,9,9,,1970-1971
William Carrier,F,41,5,3,8,-1,2015-2016
Justin Bailey,F,52,5,3,8,-4,1974-1976
Dainius Zubrus,F,19,4,4,8,-3,1971-1973
Drake Caggiula,F,29,4,4,8,-9,1995-2006
Ron Schock,F,40,4,4,8,-5,1978-1983
Jordan Nolan,F,69,4,4,8,-13,1981-1986
Cal OReilly,F,31,3,5,8,-7,1991-1992
Jason Botterill,F,36,3,5,8,1,1970-1971
Barrie Moore,F,34,2,6,8,1,2002-2003
Will Butcher,D,35,2,6,8,-10,1973-1976
Lou Franceschetti,F,36,1,7,8,2,2011-2014
Brayden McNabb,D,37,1,7,8,0,1974-1975
Robert H�gg,D,48,1,7,8,-9,1987-1990
Bob Hess,D,33,0,8,8,6,1970-1975
Taylor Fedun,D,34,0,8,8,2,1994-1995
Mattias Samuelsson,D,42,0,8,8,-11,2014-2015
Scott Pearson,F,41,6,1,7,-7,1987-1990
Tobias Rieder,F,44,5,2,7,-9,1971-1975
Andrew Peters,F,200,4,3,7,-12,1988-1992
Zack Kassian,F,27,3,4,7,-1,2019-2022
Claude Verret,F,14,2,5,7,-5,2002-2014
Phil Russell,D,18,2,5,7,-8,2001-2004
Rob Conn,F,28,2,5,7,-9,2013-2015
Andy Delmore,D,37,2,5,7,-5,2017-2022
Doug Houda,D,68,2,5,7,2,1989-1995
Nolan Pratt,D,55,1,6,7,1,1980-1985
Robyn Regehr,D,105,1,6,7,-16,1991-1994
Ron Fischer,D,18,0,7,7,-3,1989-1990
Jean-Guy Talbot,D,57,0,7,7,-20,1979-1985
Jacques Cloutier,G,144,0,7,7,,2009-2011
Jody Gage,F,18,3,3,6,-6,2018-2021
Cory Conacher,F,19,3,3,6,-7,1995-1997
Alexander Nylander,F,19,3,3,6,-9,2008-2009
Scott Thomas,F,39,3,3,6,-4,1999-2000
Dave Schultz,F,41,3,3,6,-12,2010-2011
Brett Murray,F,21,2,4,6,-2,2013-2018
Anatoli Semenov,F,25,2,4,6,-3,1993-1996
Timo Jutila,D,10,1,5,6,-5,2020-2022
Lawrence Pilut,D,46,1,5,6,-12,1970-1971
Clint Malarchuk,G,102,0,6,6,,2009-2015
Paul Kruse,F,66,4,1,5,-1,1982-1983
Mark Jankowski,F,19,2,3,5,2,1986-1989
Tim Schaller,F,35,2,3,5,-2,1996-1999
Dmitri Kulikov,D,47,2,3,5,-26,2015-2019
Ed Ronan,F,18,1,4,5,4,2013-2015
Brian Engblom,D,30,1,4,5,2,1995-1998
Carlo Colaiacovo,D,36,1,4,5,-11,2010-2011
Shaone Morrisonn,D,62,1,4,5,-2,2016-2017
Brad Miller,D,63,1,4,5,-6,2017-2018
Raffi Torres,F,14,0,5,5,-3,1973-1974
Joe Kowal,F,22,0,5,5,3,2000-2006
Brendan Guhle,D,23,0,5,5,-4,2005-2007
Tyson Strachan,D,46,0,5,5,-30,2005-2009
Martin Biron,G,300,0,5,5,,2016-2019
Chris Langevin,F,22,3,1,4,1,2017-2019
Dominik Kahun,F,6,2,2,4,2,2015-2017
Paul Brydges,F,15,2,2,4,4,2015-2018
Patrik Berglund,F,23,2,2,4,-5,1970-1972
Jacob Josefson,F,39,2,2,4,-4,2016-2022
John Hayden,F,52,2,2,4,-11,2018-2022
Butch Deadmarsh,F,56,2,2,4,-15,2013-2014
Bob Errey,F,8,1,3,4,2,1984-1987
Paul Szczechura,F,9,1,3,4,0,2012-2014
Mark Renaud,D,10,1,3,4,1,2005-2010
Dominic Moore,F,18,1,3,4,-1,1986-1987
Michael Frol�k,F,19,1,3,4,-2,2005-2010
Greg Brown,D,49,1,3,4,-25,2012-2013
Sergei Petrenko,F,14,0,4,4,-3,1986-1990
Adam Pardy,D,17,0,4,4,4,2010-2011
Casey Fitzgerald,D,25,0,4,4,-16,1990-1991
Cory Sarich,D,46,0,4,4,5,1998-2004
Gary Bromley,G,63,0,4,4,,1980-1985
Grant Fuhr,G,64,0,4,4,,1991-1993
Greg Paslawski,F,12,2,1,3,0,1994-1996
C.J. Smith,F,14,2,1,3,-1,1995-2000
Seth Griffith,F,21,2,1,3,-6,1970-1987
Rod Zaine,F,24,2,1,3,-14,1970-1971
Geordie Robertson,F,5,1,2,3,-1,2021-2022
Steven Fogarty,F,9,1,2,3,2,2003-2009
Scott Metcalfe,F,17,1,2,3,-2,1981-1985
Zac Dalpe,F,21,1,2,3,-11,1993-1994
Mike Boland,D,22,1,2,3,5,2018-2020
Hudson Fasching,F,22,1,2,3,0,1998-2004
Ron Busniuk,F,6,0,3,3,-1,1993-1999
Mark Ferner,D,15,0,3,3,0,1978-1990
Norm Milley,F,15,0,3,3,-2,2003-2019
Jeff Jillson,D,16,0,3,3,-3,2012-2014
Tom Draper,G,37,0,3,3,,2017-2018
Ray McKay,D,40,0,3,3,-12,2007-2008
Derek Grant,F,40,0,3,3,-3,1970-1974
Roger Crozier,G,202,0,3,3,,1991-1995
Jim Jackson,F,5,2,0,2,0,1986-1990
T.J. Brennan,D,21,2,0,2,-1,1994-2000
Jack Quinn,F,2,1,1,2,0,2021-2022
Paul Byron,F,8,1,1,2,0,1985-1993
Joe Juneau,F,9,1,1,2,-1,2001-2006
Real Lemieux,F,11,1,1,2,0,2012-2022
Mike Funk,D,9,0,2,2,-1,2021-2022
Jir� Sejba,F,11,0,2,2,-5,1971-1985
Brad Brown,D,13,0,2,2,3,1979-1993
Linus Omark,F,13,0,2,2,-5,1977-1978
Matt Hunwick,D,14,0,2,2,-7,1997-2002
Matt Irwin,D,24,0,2,2,-10,1989-2003
Chad Ruhwedel,D,33,0,2,2,0,2017-2018
Paul McIntosh,D,48,0,2,2,-2,1985-1989
Chad Johnson,G,81,0,2,2,,2011-2013
Carter Hutton,G,94,0,2,2,,2014-2021
Dave Dryden,G,120,0,2,2,,1983-1984
Robin Lehner,G,133,0,2,2,,1975-1979
Travis Turnbull,F,3,1,0,1,0,1972-1973
Ethan Prow,D,4,1,0,1,-1,2020-2021
Doug MacDonald,F,11,1,0,1,-3,2013-2021
Domenic Pittis,F,14,1,0,1,0,2008-2011
Mika Noronen,G,67,1,0,1,,1971-1979
John Scott,D,90,1,0,1,-13,1982-1983
Francois Lacombe,D,1,0,1,1,-2,1971-1975
Chris Thorburn,F,2,0,1,1,-1,2015-2020
Connor Knapp,G,2,0,1,1,,1998-2000
Joel Savage,F,3,0,1,1,-2,1972-1974
Jim Walsh,D,4,0,1,1,1,1996-1997
Cole Schneider,F,6,0,1,1,2,2003-2012
Wayne Simmonds,F,7,0,1,1,-4,1979-1989
Don McSween,D,9,0,1,1,-2,2012-2016
Steve Ludzik,F,11,0,1,1,-2,2020-2022
Peter Ambroziak,F,12,0,1,1,-1,1985-1987
Terry Ball,D,12,0,1,1,-7,1986-1992
Jason Holland,D,12,0,1,1,-1,2006-2008
Bill Inglis,F,14,0,1,1,-4,2020-2022
Todd Simon,F,15,0,1,1,-3,1997-2000
Remi Elie,F,16,0,1,1,-3,1998-2000
Brian Curran,D,20,0,1,1,-3,1996-2004
Zenon Konopka,F,23,0,1,1,-4,1976-1985
Jean-Luc Grand-Pierre,D,27,0,1,1,-1,1980-1983
Randy Hillier,D,28,0,1,1,-14,1990-1991
Dustin Tokarski,G,36,0,1,1,,1976-1983
Joe Daley,G,38,0,1,1,,2017-2020
Ed Hospodar,D,42,0,1,1,-1,2014-2016
Patrick Lalime,G,47,0,1,1,,1970-1971
Gerry Desjardins,G,116,0,1,1,,2015-2017
Linus Ullmark,G,117,0,1,1,,1977-1978
Jeff Eatough,F,1,0,0,0,-1,1972-1985
Francois Guay,F,1,0,0,0,0,1978-1980
Trent Kaese,F,1,0,0,0,0,2012-2014
Reed Larson,D,1,0,0,0,1,1977-1986
Sean McMorrow,F,1,0,0,0,0,1990-1991
David Moravec,F,1,0,0,0,-1,2006-2013
Brian Perry,F,1,0,0,0,0,1996-1997
Peter Skudra,G,1,0,0,0,,1970-1972
Dean Sylvester,F,1,0,0,0,-1,1988-1992
Joel Armia,F,1,0,0,0,0,1995-1999
Andrei Makarov,G,1,0,0,0,,2020-2021
Dalton Smith,F,1,0,0,0,1,2018-2020
Sean Malone,F,1,0,0,0,0,1987-1990
Adam Wilcox,G,1,0,0,0,,1995-1998
Ryan MacInnis,F,1,0,0,0,0,2019-2020
Jason Kasdorf,G,1,0,0,0,,1993-1994
Christian Wolanin,D,1,0,0,0,-2,1993-1995
Brandon Biro,F,1,0,0,0,0,2018-2022
James Black,F,2,0,0,0,0,2000-2001
Darren Eliot,G,2,0,0,0,,1992-2002
Paul Gardner,F,2,0,0,0,-3,1975-1977
Randy Ireland,G,2,0,0,0,,2016-2021
David Littman,G,2,0,0,0,,2019-2020
Mitch Molloy,F,2,0,0,0,0,1975-1982
Mark Parrish,F,2,0,0,0,-2,1985-1988
Wayne Ramsey,D,2,0,0,0,0,1970-1972
Kai Suikkanen,F,2,0,0,0,0,1988-1989
Doug Trapp,F,2,0,0,0,0,1989-1992
Drew MacIntyre,G,2,0,0,0,,2018-2020
Derek Whitmore,F,2,0,0,0,0,2006-2009
Erik Burgdoerfer,D,2,0,0,0,-1,1973-1977
John Peterka,F,2,0,0,0,0,2020-2021
Jere Gillis,F,3,0,0,0,-6,2006-2015
Jean-Guy Lagace,D,3,0,0,0,0,1974-1978
Bryan McSheffrey,F,3,0,0,0,1,1994-1995
Bob Richer,F,3,0,0,0,0,1977-1979
Steve Smith,D,3,0,0,0,0,2013-2015
Zach Redmond,D,3,0,0,0,1,2014-2015
Danny ORegan,F,3,0,0,0,1,2010-2012
Mike Card,D,4,0,0,0,0,2021-2022
Alex Tidey,F,4,0,0,0,-2,1981-1983
Malcolm Subban,G,4,0,0,0,,2011-2014
Jean-Sebastien Dea,F,4,0,0,0,-1,1990-1995
John Gilmour,D,4,0,0,0,-2,1991-1995
John Blue,G,5,0,0,0,,1992-1995
Peter Ciavaglia,F,5,0,0,0,1,1998-1999
Ty Conklin,G,5,0,0,0,,2011-2012
Richard Hajdu,F,5,0,0,0,2,1970-1971
Mike Hurlbut,D,5,0,0,0,2,2001-2014
Dave McLlwain,F,5,0,0,0,-3,1990-1992
Dean Melanson,D,5,0,0,0,-1,1999-2004
Phil Myre,G,5,0,0,0,,2008-2009
Scott Nichol,F,5,0,0,0,0,2017-2019
Colin Stuart,F,5,0,0,0,-2,1970-1974
Joe Finley,F,5,0,0,0,-3,2007-2008
Brady Austin,D,5,0,0,0,0,1992-1994
Dale Degray,D,6,0,0,0,-4,2018-2022
Paul Harrison,G,6,0,0,0,,2005-2006
Grant Jennings,D,6,0,0,0,1,1976-1978
Jaroslav Kristek,F,6,0,0,0,-2,1974-1976
Robb Stauber,G,6,0,0,0,,2020-2022
Mikael Tellqvist,G,6,0,0,0,,2009-2010
Brandon Davidson,D,6,0,0,0,-4,1986-1987
Michael Houser,G,6,0,0,0,,1995-1997
Val James,F,7,0,0,0,-1,2011-2014
Nathan Lieuwen,G,7,0,0,0,,1993-1995
Bob Essensa,G,9,0,0,0,,1999-2001
Jerry DAmigo,F,9,0,0,0,-4,2021-2022
Kyle Criscuolo,F,9,0,0,0,-4,1983-1991
Doug Janik,D,10,0,0,0,1,1987-1992
Rumun Ndur,D,11,0,0,0,1,2011-2012
Dan Catenacci,F,11,0,0,0,-2,2015-2021
Darcy Loewen,F,12,0,0,0,-7,1988-1992
Brian McDonald,F,12,0,0,0,-8,1979-1983
Mike McMahon,D,12,0,0,0,-9,2005-2014
Jocelyn Thibault,G,12,0,0,0,,1995-2003
Denis Tsygurov,D,12,0,0,0,-2,2013-2016
Aaron Dell,G,12,0,0,0,,1983-1985
Hap Myers,D,13,0,0,0,-10,2019-2020
Matt Hackett,G,13,0,0,0,,1981-1986
Jonas Johansson,G,13,0,0,0,,1988-1991
Ukko-Pekka Luukkonen,G,13,0,0,0,,1981-1982
Radoslav Hecl,D,14,0,0,0,0,1995-2000
William Borgen,D,14,0,0,0,-9,1998-2003
Anders Lindb�ck,G,16,0,0,0,,1970-1972
Jim Hofford,D,17,0,0,0,-2,2007-2016
Joe Noris,D,18,0,0,0,-4,1989-1992
Norm Farr,G,19,0,0,0,,2011-2012
Morris Titanic,F,19,0,0,0,-3,1982-1985
Matt Tennyson,D,19,0,0,0,-12,2017-2018
Al Smith,G,21,0,0,0,,1995-1999
Darcy Wakaluk,G,22,0,0,0,,2017-2020
Craig Anderson,G,24,0,0,0,,2021-2022
Andrei Trefilov,G,25,0,0,0,,1991-1994
Anders Nilsson,G,26,0,0,0,,1997-2003
Michal Neuvirth,G,29,0,0,0,,1970-1974
Steve Shields,G,31,0,0,0,,2013-2015
Dwayne Roloson,G,32,0,0,0,,1971-1972
Jhonas Enroth,G,118,0,0,0,,1994-2004
