Gilbert Perreault,F,1191,512,814,1326,41,1970-1987
Dave Andreychuk,F,837,368,436,804,22,1982-2001
Rick Martin,F,681,382,313,695,12,1971-1981
Craig Ramsay,F,1070,252,420,672,324,1971-1985
Phil Housley,D,608,178,380,558,3,1982-1990
Rene Robert,F,524,222,330,552,47,1971-1979
Don Luce,F,766,216,310,526,214,1971-1981
Jason Pominville,F,733,217,304,521,20,2003-2019
Mike Foligno,F,664,247,264,511,115,1981-1991
Danny Gare,F,503,267,233,500,187,1974-1982
Thomas Vanek,F,598,254,243,497,29,2005-2014
Miroslav Satan,F,578,224,232,456,44,1996-2004
Alexander Mogilny,F,381,211,233,444,44,1989-1995
Derek Roy,F,549,161,266,427,39,2003-2012
Pat Lafontaine,F,268,158,227,385,3,1991-1997
Dale Hawerchuk,F,342,110,275,385,-29,1990-1995
Ric Seiling,F,664,176,200,376,116,1977-1986
Jack Eichel,F,375,139,216,355,-69,2015-2021
Jochen Hecht,F,613,138,207,345,67,2002-2013
Maxim Afinogenov,F,569,134,200,334,-26,1999-2009
Jim Lorentz,F,487,134,197,331,-6,1986-1992
Christian Ruuttu,F,438,101,230,331,16,1971-1978
Mike Ramsey,D,911,73,256,329,166,1979-1993
Pierre Turgeon,F,322,122,201,323,13,1987-1992
Drew Stafford,F,563,145,177,322,-20,2006-2015
Tim Connolly,F,464,94,226,320,-2,2001-2011
Andre Savard,F,467,130,175,305,67,1976-1983
Donald Audette,F,421,166,131,297,-6,1989-2001
Sam Reinhart,F,454,134,161,295,-97,2014-2021
Alexei Zhitnik,D,712,55,234,289,-33,1994-2004
Doug Bodger,D,479,54,233,287,15,1988-1996
Lindy Ruff,F,608,102,183,285,3,1979-1989
Jerry Korab,D,537,67,216,283,78,1973-1985
John Tucker,F,345,116,154,270,2,1983-1991
Tony McKegney,F,363,127,141,268,39,1978-1983
Curtis Brown,F,542,109,143,252,76,1994-2004
Rasmus Ristolainen,D,542,46,199,245,-163,2013-2021
Bill Hajt,D,854,42,202,244,320,1973-1987
Ales Kotalik,F,426,114,126,240,-24,2001-2009
Tyler Ennis,F,419,97,139,236,-65,1993-1999
Derek Plante,F,395,91,145,236,21,2009-2017
Daniel Briere,F,225,92,138,230,14,2002-2007
Jim Schoenfeld,D,584,45,183,228,230,1972-1985
Jean-Pierre Dumont,F,362,102,121,223,-33,2000-2006
Mike Peca,F,363,96,121,217,50,1995-2000
John Van Boxmeer,D,294,49,166,215,70,1979-1983
Gerry Meehan,F,306,94,114,208,-44,1970-1975
Gilles Hamel,F,365,92,114,206,-28,1980-1986
Paul Cyr,F,343,85,111,196,-29,1982-1988
Kyle Okposo,F,369,76,114,190,-67,2016-2022
Chris Drury,F,234,85,104,189,-2,2003-2007
Richard Smehlik,D,589,47,135,182,67,1992-2002
Paul Gaustad,F,479,71,110,181,14,2002-2012
Ryan OReilly,F,224,65,111,176,-40,2015-2018
Brian Campbell,D,391,32,144,176,-7,1999-2008
Stu Barnes,F,310,67,105,172,-11,1998-2003
Jocelyn Guevremont,D,324,38,130,168,143,1974-1979
Brian Holzinger,F,352,70,97,167,-6,1994-2000
Jason Woolley,D,365,40,125,165,31,1997-2003
Rick Dudley,F,279,70,94,164,57,1972-1981
Derek Smith,F,244,65,98,163,38,1975-1982
Michal Grosek,F,308,62,98,160,67,1995-2000
Jason Dawe,F,290,79,79,158,11,1993-1998
Brad May,F,425,67,89,156,-10,1991-1998
Zemgus Girgensons,F,532,71,83,154,-59,2018-2022
Tyler Myers,D,365,45,106,151,-31,2013-2022
Yuri Khmylev,F,254,63,87,150,15,2018-2022
Rasmus Dahlin,D,264,27,123,150,-74,2009-2015
Jeff Skinner,F,261,88,60,148,-42,1992-1996
Dmitri Kalinin,D,466,34,111,145,11,1999-2008
V�clav Varada,F,376,46,98,144,12,1995-2003
Scott Arniel,F,295,64,74,138,21,1986-1990
Rick Vaive,F,189,74,62,136,25,1988-1992
Dixon Ward,F,307,56,80,136,38,1995-2000
Richie Dunn,D,327,27,105,132,36,1977-1989
Chris Gratton,F,244,50,81,131,-4,1999-2003
Matthew Barnaby,F,317,47,79,126,11,1981-1986
Hannu Virta,D,245,25,101,126,16,1992-1999
Matt Moulson,F,297,46,77,123,-37,2013-2018
Evander Kane,F,196,68,50,118,-45,2015-2018
Randy Wood,F,236,60,57,117,8,2018-2022
Marcus Foligno,F,347,49,67,116,-17,1991-1994
Henrik Tallinder,D,532,22,94,116,25,2011-2017
Fred Stanfield,F,248,42,73,115,4,2001-2014
Ray Sheppard,F,159,64,50,114,-10,1974-1978
Brian Spencer,F,240,42,72,114,27,1987-1990
Victor Olofsson,F,175,50,63,113,-42,1973-1977
Benoit Hogue,F,196,45,67,112,-10,1987-1992
Sean McKenna,F,237,56,53,109,-14,1981-1986
Peter McNab,F,154,49,59,108,28,1973-1976
Brent Peterson,F,265,43,63,106,28,1981-1985
Adam Mair,F,498,35,70,105,-10,2005-2010
Toni Lydman,D,371,14,91,105,30,2002-2010
Brian Gionta,F,230,40,63,103,-29,2014-2017
Uwe Krupp,D,327,25,78,103,19,1986-1992
Garry Galley,D,163,15,87,102,12,1994-1997
Adam Creighton,F,172,40,60,100,-2,1983-1989
Larry Playfair,D,577,24,76,100,2,1978-1990
Cody Hodgson,F,218,44,55,99,-65,1995-1998
Randy Burridge,F,159,39,60,99,17,2011-2015
Dale McCourt,F,119,41,57,98,-14,1981-1984
Jaroslav Spacek,D,205,22,76,98,29,2006-2009
Jay McKee,D,582,17,81,98,45,1995-2006
Johan Larsson,F,392,38,59,97,-41,2013-2020
Steve Atkinson,F,255,49,47,96,-24,1970-1974
Andrej Sekera,D,339,17,75,92,6,2006-2013
Rob Ray,F,889,40,50,90,-38,1989-2003
Doug Smith,F,162,35,54,89,-27,1985-1988
Grant Ledyard,D,240,18,71,89,10,1988-1993
Christian Ehrhoff,D,192,16,71,87,-23,2011-2014
Teppo Numminen,D,212,6,80,86,19,2005-2009
Gary McAdam,F,227,40,45,85,12,1970-1972
Phil Goyette,F,97,18,67,85,-26,1975-1983
Bob Sweeney,F,185,37,44,81,-1,2018-2022
Wayne Presley,F,202,48,32,80,30,1992-1995
Taylor Pyatt,F,230,38,42,80,-12,1991-1995
Tage Thompson,F,169,45,34,79,-41,2001-2006
Clarke MacArthur,F,187,41,38,79,-11,2006-2010
Erik Rasmussen,F,281,33,46,79,8,1991-1996
Dave Hannan,F,249,23,56,79,24,1997-2002
Ken Sutton,D,232,18,60,78,-4,1990-1995
Lee Fogolin,D,338,8,70,78,28,1974-1987
Daniel Paille,F,195,35,42,77,20,2017-2022
Jake McCabe,D,353,18,59,77,-28,2005-2010
Alan Haworth,F,106,37,38,75,-1,2013-2021
James Patrick,D,345,23,51,74,40,1980-1982
Casey Mittelstadt,F,182,30,43,73,-45,1998-2004
Jean-Francois Sauve,F,98,24,49,73,5,1980-1983
Nathan Gerbe,F,188,29,43,72,14,2008-2013
Dave Snuggerud,F,215,26,46,72,-8,1989-1992
Evan Rodrigues,F,192,26,45,71,-30,2015-2020
Mike Grier,F,241,23,47,70,-1,2003-2011
Darryl Shannon,D,255,12,56,68,87,1995-1999
Eddie Shack,F,111,36,31,67,-39,1970-1972
Jordan Leopold,D,174,25,42,67,-13,2010-2013
Zach Bogosian,D,243,13,54,67,-49,2014-2020
Geoff Sanderson,F,168,29,36,65,18,1997-2000
Yvon Lambert,F,77,25,39,64,22,1981-1982
Al Hamilton,D,145,6,58,64,-34,1970-1972
Jacques Richard,F,155,24,38,62,8,1975-1979
Mike Hartman,F,225,34,26,60,-12,1983-1985
Real Cloutier,F,82,24,36,60,-4,1986-1991
Mark Napier,F,128,26,30,56,-11,1986-1989
Steve Patrick,F,152,21,34,55,4,1999-2001
Doug Gilmour,F,82,10,45,55,6,1987-1989
Calle Johansson,D,118,6,49,55,5,1980-1985
Patrick Kaleta,F,348,27,27,54,-18,1991-1995
Mike Robitaille,D,170,8,46,54,0,1971-1975
Petr Svoboda,D,139,5,49,54,1,2006-2015
Conor Sheary,F,133,23,30,53,-22,2018-2020
Mike Weber,D,341,9,44,53,-42,2007-2016
Larry Carriere,D,206,9,43,52,14,1972-1978
Mal Davis,F,89,29,22,51,-8,1982-1986
Ken Priestlay,F,117,25,25,50,-10,1986-1990
Don Marshall,F,62,20,29,49,-13,1970-1971
Steve Montador,D,151,10,39,49,16,2020-2022
Dylan Cozens,F,107,16,32,48,-29,2009-2011
Ville Leino,F,137,10,36,46,-18,2011-2014
Wayne Primeau,F,225,19,25,44,-9,1984-1987
Gates Orlando,F,98,18,26,44,-9,2012-2014
Steve Ott,F,107,18,26,44,-23,2017-2020
Marco Scandella,D,176,14,30,44,-19,1994-2000
Kevin Maguire,F,167,18,25,43,5,1987-1990
Terry Martin,F,148,20,22,42,-12,2018-2021
Brandon Montour,D,112,13,29,42,-4,1975-1979
Rhett Warrener,D,266,9,33,42,47,2005-2010
Nathan Paetsch,D,157,7,35,42,17,2008-2011
Craig Rivet,D,165,4,38,42,-7,1998-2003
Matt Ellis,F,286,18,23,41,-22,1971-1973
Brian Flynn,F,159,17,24,41,-7,2012-2015
Larry Hillman,D,121,6,35,41,-24,1970-1974
Tracy Pratt,D,210,2,39,41,0,2008-2015
Mike Moller,F,127,13,27,40,1,1980-1985
Tony Tanti,F,80,16,23,39,-2,1990-1992
Norm Gratton,F,103,15,23,38,-7,1972-1973
Hugh Harris,F,60,12,26,38,8,1972-1975
Henri Jokiharju,D,162,10,28,38,-19,2019-2022
Wilf Paiement,F,56,20,17,37,3,2019-2022
Rasmus Asplund,F,124,14,23,37,-14,2012-2022
Brad Boyes,F,86,13,24,37,4,1986-1987
Colin Miller,D,135,7,30,37,-30,2010-2012
Mark Pysyk,D,189,7,30,37,-21,1985-1989
Mikael Andersson,F,99,4,33,37,3,2019-2022
Cody Franson,D,127,7,29,36,-10,2015-2017
Chris Butler,D,155,5,31,36,4,2008-2011
Jeff Parker,F,137,16,19,35,-7,1986-1990
Larry Mickey,F,117,20,14,34,0,1986-1988
Clark Gillies,F,86,15,19,34,1,1970-1972
Mike Wilson,D,231,11,23,34,49,1971-1975
Doug Barrie,D,102,6,28,34,-40,1995-1999
Vladimir Tsyplakov,F,70,13,20,33,19,2021-2022
Cody McCormick,F,201,11,22,33,-24,1999-2001
Paul Andrea,F,47,11,21,32,-15,2009-2015
Shawn Anderson,D,113,6,26,32,5,1970-1971
Ron Anderson,F,111,14,16,30,-22,1986-1990
Normand Lacombe,F,94,12,18,30,-6,2019-2020
Nick Deslauriers,F,211,12,18,30,-54,1989-1992
Alex Tuch,F,37,9,21,30,4,1984-1987
Marcus Johansson,F,60,9,21,30,-12,1970-1972
Kevin Haller,D,81,7,23,30,-4,2013-2017
Larry Keenan,F,65,9,20,29,-14,1970-1972
David Fenyves,D,148,2,27,29,7,1982-1987
Steve Dykstra,D,128,5,23,28,-9,1985-1988
Jamie McGinn,F,63,14,13,27,-10,1993-1995
Craig Simpson,F,46,12,15,27,-8,2015-2016
Mike Donnelly,F,74,11,16,27,-6,1987-1990
Luke Adam,F,87,15,11,26,-11,2008-2010
John Gould,F,92,14,12,26,2,2010-2014
Tim Kennedy,F,79,10,16,26,-3,1971-1980
Dean Kennedy,D,144,6,20,26,-7,1989-1991
Josh Gorges,D,223,3,23,26,-42,2014-2018
Chris Stewart,F,66,11,14,25,-32,2013-2015
Jim Wiemer,D,74,8,17,25,-3,1982-1985
Randy Moller,D,126,5,20,25,2,1991-1994
Darrin Shannon,F,55,10,14,24,-6,1988-1992
Dick Duff,F,61,9,15,24,-20,1970-1972
Rory Fitzpatrick,D,157,9,15,24,-32,1971-1972
Chris Evans,D,61,6,18,24,-20,2001-2006
Vince Hinostroza,F,49,11,12,23,-8,2021-2022
Kevin OShea,F,93,10,13,23,-30,1986-1987
Philippe Boucher,D,65,7,16,23,6,1992-1995
Tom Kurvers,D,55,6,17,23,-13,1993-1996
Mark Astley,D,75,4,19,23,-15,1970-1972
Tim Horton,D,124,1,22,23,15,1972-1974
Mikko M�kel�,F,60,15,7,22,-2,2001-2002
Denis Hamel,F,130,13,9,22,-8,1984-1985
Bob Mongrain,F,70,11,11,22,2,1990-1991
Vyacheslav Kozlov,F,38,9,13,22,0,1979-1981
Rob McClanahan,F,66,5,17,22,-11,1979-1985
Dave Maloney,D,52,1,21,22,20,1999-2003
Paul Terbenche,D,121,2,19,21,-7,1970-1974
Jimmy Vesey,F,64,9,11,20,12,2019-2020
Chris Taylor,F,90,8,12,20,-4,1977-1979
Bill Stewart,D,81,3,17,20,5,1999-2004
Craig Muni,D,160,2,18,20,12,1993-1996
Benoit Pouliot,F,74,13,6,19,-8,2020-2021
Curtis Lazar,F,71,10,9,19,-7,2021-2022
Bob Corkum,F,106,10,9,19,-12,2017-2020
Scott Wilson,F,70,7,12,19,-24,2010-2011
Rob Niedermayer,F,71,5,14,19,-8,2019-2021
Jim Watson,D,144,4,15,19,-61,2017-2018
Taylor Hall,F,37,2,17,19,-21,1989-2002
Colin Patterson,F,88,8,10,18,-6,2020-2022
Randy Wyrozub,F,100,8,10,18,-13,1970-1972
Cody Eakin,F,110,7,11,18,-21,1970-1972
Floyd Smith,F,83,6,12,18,-16,1991-1993
Casey Nelson,D,93,4,14,18,-15,2015-2019
Joe Reekie,D,104,3,15,18,7,1970-1974
Jacob Bryson,D,98,2,16,18,-7,2020-2022
Doug Rombough,F,51,8,9,17,5,1985-1989
Peyton Krebs,F,35,7,10,17,-12,1972-1974
Jamie McBain,D,69,6,11,17,-13,2013-2014
Eric Boulton,F,172,5,12,17,-3,2000-2004
Tom Barrasso,G,266,0,17,17,,1983-1989
Danny Lawson,F,78,10,6,16,-22,1971-1972
Mike Byers,F,46,9,7,16,-20,2005-2007
Jir� Novotn�,F,64,8,8,16,-7,2013-2015
Charlie Huddy,D,85,7,9,16,-7,1970-1971
Reg Fleming,F,78,6,10,16,-8,1971-1972
Vladimir Sobotka,F,85,6,10,16,-18,2018-2020
Gord Donnelly,F,134,5,11,16,-1,1994-1997
Nikita Zadorov,D,67,4,12,16,-14,2017-2019
Nathan Beaulieu,D,89,4,12,16,-18,1984-1989
Bob Halkidis,D,89,2,14,16,6,1991-1994
Bob Logan,F,38,10,5,15,6,1986-1988
Brent Hughes,F,76,5,10,15,-9,2007-2012
Jay Wells,D,85,3,12,15,-20,1995-1996
Marc-Andre Gragnani,D,59,2,13,15,10,1989-1992
Andrej Meszaros,D,60,7,7,14,-13,1986-1987
Torrey Mitchell,F,60,7,7,14,-6,2011-2014
Alexander Sulzer,D,57,6,8,14,2,2013-2015
Mikhail Grigorenko,F,68,6,8,14,-14,2014-2015
David Legwand,F,79,5,9,14,-4,2012-2015
Jim Korn,F,52,4,10,14,-3,1975-1979
Ken Breitenbach,D,68,1,13,14,7,2015-2016
Daren Puppa,G,215,0,14,14,,1985-1993
Don Lever,F,39,10,3,13,-8,2006-2011
Michael Ryan,F,65,7,6,13,-12,1985-1987
Pat Hughes,F,50,4,9,13,-5,1985-1986
Keith Carney,D,51,4,9,13,-1,1991-1994
Riley Sheahan,F,53,4,9,13,-8,2020-2021
Mark Mancari,F,36,3,10,13,-3,2006-2008
Bob Boughner,D,177,2,11,13,20,1995-1998
Dominik Hasek,G,491,0,13,13,,1992-2001
Anders Bjork,F,66,7,5,12,-19,2000-2001
Steve Heinze,F,14,5,7,12,6,1970-1971
Cliff Schmautz,F,26,5,7,12,-11,2020-2022
Matt DAgostini,F,49,5,6,11,-14,1992-1995
Bill Houlder,D,32,4,7,11,1,1990-1993
Viktor Gordiouk,F,26,3,8,11,1,2020-2022
Don Edwards,G,307,0,11,11,,2013-2014
Arttu Ruotsalainen,F,35,7,3,10,-10,1976-1982
Nicholas Baptiste,F,47,7,3,10,-3,2002-2004
Randy Cunneyworth,F,35,4,6,10,-2,2020-2021
Kevin Porter,F,43,4,6,10,-6,1980-1999
Eric Staal,F,32,3,7,10,-20,2020-2022
Milan Bartovic,F,26,2,8,10,1,2012-2014
Justin Falk,D,98,1,9,10,-19,2017-2018
Viktor Antipin,D,47,0,10,10,-9,2016-2018
Dane Jackson,F,22,5,4,9,3,2016-2018
Phil Varone,F,42,5,4,9,-16,2007-2008
Skip Krake,F,74,4,5,9,-21,1995-1996
Steve Bernier,F,17,3,6,9,1,1987-1989
Corey Tropp,F,43,3,6,9,-8,2013-2016
Jan Ludvig,F,26,1,8,9,0,2011-2014
Andre Benoit,D,59,1,8,9,-19,2014-2015
Bob Sauve,G,246,0,9,9,,1970-1971
Ryan Miller,G,540,0,9,9,,2002-2014
William Carrier,F,41,5,3,8,-1,2006-2007
Justin Bailey,F,52,5,3,8,-4,2020-2022
Dainius Zubrus,F,19,4,4,8,-3,2015-2017
Drake Caggiula,F,29,4,4,8,-9,1980-1982
Ron Schock,F,40,4,4,8,-5,2016-2018
Jordan Nolan,F,69,4,4,8,-13,1995-1997
Cal OReilly,F,31,3,5,8,-7,2021-2022
Jason Botterill,F,36,3,5,8,1,1990-1992
Barrie Moore,F,34,2,6,8,1,2002-2004
Will Butcher,D,35,2,6,8,-10,2011-2014
Lou Franceschetti,F,36,1,7,8,2,1977-1978
Brayden McNabb,D,37,1,7,8,0,2016-2017
Robert H�gg,D,48,1,7,8,-9,2021-2022
Bob Hess,D,33,0,8,8,6,2015-2018
Taylor Fedun,D,34,0,8,8,2,2017-2018
Mattias Samuelsson,D,42,0,8,8,-11,1976-1985
Scott Pearson,F,41,6,1,7,-7,1983-1985
Tobias Rieder,F,44,5,2,7,-9,1981-1983
Andrew Peters,F,200,4,3,7,-12,1985-1987
Zack Kassian,F,27,3,4,7,-1,2011-2012
Claude Verret,F,14,2,5,7,-5,1995-1996
Phil Russell,D,18,2,5,7,-8,2003-2004
Rob Conn,F,28,2,5,7,-9,1994-1996
Andy Delmore,D,37,2,5,7,-5,2020-2021
Doug Houda,D,68,2,5,7,2,2007-2008
Nolan Pratt,D,55,1,6,7,1,1970-1971
Robyn Regehr,D,105,1,6,7,-16,1994-2003
Ron Fischer,D,18,0,7,7,-3,2011-2013
Jean-Guy Talbot,D,57,0,7,7,-20,1981-1989
Jacques Cloutier,G,144,0,7,7,,2003-2009
Jody Gage,F,18,3,3,6,-6,1984-1985
Cory Conacher,F,19,3,3,6,-7,1985-1992
Alexander Nylander,F,19,3,3,6,-9,2013-2014
Scott Thomas,F,39,3,3,6,-4,2016-2019
Dave Schultz,F,41,3,3,6,-12,2020-2022
Brett Murray,F,21,2,4,6,-2,1996-1997
Anatoli Semenov,F,25,2,4,6,-3,1992-1994
Timo Jutila,D,10,1,5,6,-5,1978-1980
Lawrence Pilut,D,46,1,5,6,-12,2018-2020
Clint Malarchuk,G,102,0,6,6,,1988-1992
Paul Kruse,F,66,4,1,5,-1,2009-2010
Mark Jankowski,F,19,2,3,5,2,1996-1997
Tim Schaller,F,35,2,3,5,-2,2021-2022
Dmitri Kulikov,D,47,2,3,5,-26,1976-1978
Ed Ronan,F,18,1,4,5,4,2016-2019
Brian Engblom,D,30,1,4,5,2,1985-1986
Carlo Colaiacovo,D,36,1,4,5,-11,2014-2016
Shaone Morrisonn,D,62,1,4,5,-2,2015-2016
Brad Miller,D,63,1,4,5,-6,2014-2015
Raffi Torres,F,14,0,5,5,-3,2016-2017
Joe Kowal,F,22,0,5,5,3,2010-2011
Brendan Guhle,D,23,0,5,5,-4,1988-1992
Tyson Strachan,D,46,0,5,5,-30,1997-2000
Martin Biron,G,300,0,5,5,,1995-2007
Chris Langevin,F,22,3,1,4,1,2019-2020
Dominik Kahun,F,6,2,2,4,2,1992-1993
Paul Brydges,F,15,2,2,4,4,2011-2012
Patrik Berglund,F,23,2,2,4,-5,1983-1984
Jacob Josefson,F,39,2,2,4,-4,1993-1994
John Hayden,F,52,2,2,4,-11,1986-1987
Butch Deadmarsh,F,56,2,2,4,-15,2012-2013
Bob Errey,F,8,1,3,4,2,2008-2009
Paul Szczechura,F,9,1,3,4,0,2019-2020
Mark Renaud,D,10,1,3,4,1,1983-1986
Dominic Moore,F,18,1,3,4,-1,2018-2019
Michael Frol�k,F,19,1,3,4,-2,2021-2022
Greg Brown,D,49,1,3,4,-25,2017-2018
Sergei Petrenko,F,14,0,4,4,-3,1998-2000
Adam Pardy,D,17,0,4,4,4,1990-1993
Casey Fitzgerald,D,25,0,4,4,-16,2021-2022
Cory Sarich,D,46,0,4,4,5,1970-1973
Gary Bromley,G,63,0,4,4,,1973-1976
Grant Fuhr,G,64,0,4,4,,1992-1995
Greg Paslawski,F,12,2,1,3,0,1982-1983
C.J. Smith,F,14,2,1,3,-1,1972-1974
Seth Griffith,F,21,2,1,3,-6,2020-2021
Rod Zaine,F,24,2,1,3,-14,1990-1991
Geordie Robertson,F,5,1,2,3,-1,2016-2021
Steven Fogarty,F,9,1,2,3,2,2001-2004
Scott Metcalfe,F,17,1,2,3,-2,1986-1989
Zac Dalpe,F,21,1,2,3,-11,2003-2006
Mike Boland,D,22,1,2,3,5,1987-1990
Hudson Fasching,F,22,1,2,3,0,2014-2015
Ron Busniuk,F,6,0,3,3,-1,2017-2018
Mark Ferner,D,15,0,3,3,0,1978-1979
Norm Milley,F,15,0,3,3,-2,2015-2018
Jeff Jillson,D,16,0,3,3,-3,1971-1972
Tom Draper,G,37,0,3,3,,1991-1993
Ray McKay,D,40,0,3,3,-12,1971-1973
Derek Grant,F,40,0,3,3,-3,2016-2017
Roger Crozier,G,202,0,3,3,,1970-1976
Jim Jackson,F,5,2,0,2,0,2021-2022
T.J. Brennan,D,21,2,0,2,-1,1987-1988
Jack Quinn,F,2,1,1,2,0,2010-2011
Paul Byron,F,8,1,1,2,0,2006-2008
Joe Juneau,F,9,1,1,2,-1,1998-1999
Real Lemieux,F,11,1,1,2,0,1973-1974
Mike Funk,D,9,0,2,2,-1,1990-1991
Jir� Sejba,F,11,0,2,2,-5,2013-2014
Brad Brown,D,13,0,2,2,3,2003-2004
Linus Omark,F,13,0,2,2,-5,2018-2019
Matt Hunwick,D,14,0,2,2,-7,2011-2013
Matt Irwin,D,24,0,2,2,-10,2020-2021
Chad Ruhwedel,D,33,0,2,2,0,2012-2016
Paul McIntosh,D,48,0,2,2,-2,1974-1976
Chad Johnson,G,81,0,2,2,,2015-2018
Carter Hutton,G,94,0,2,2,,2018-2021
Dave Dryden,G,120,0,2,2,,1970-1974
Robin Lehner,G,133,0,2,2,,2015-2018
Travis Turnbull,F,3,1,0,1,0,1970-1971
Ethan Prow,D,4,1,0,1,-1,2013-2014
Doug MacDonald,F,11,1,0,1,-3,2005-2006
Domenic Pittis,F,14,1,0,1,0,2011-2012
Mika Noronen,G,67,1,0,1,,1990-1991
John Scott,D,90,1,0,1,-13,1981-1982
Francois Lacombe,D,1,0,1,1,-2,2021-2022
Chris Thorburn,F,2,0,1,1,-1,2015-2017
Connor Knapp,G,2,0,1,1,,2019-2020
Joel Savage,F,3,0,1,1,-2,1987-1990
Jim Walsh,D,4,0,1,1,1,1989-1990
Cole Schneider,F,6,0,1,1,2,1992-1995
Wayne Simmonds,F,7,0,1,1,-4,1970-1972
Don McSween,D,9,0,1,1,-2,1994-1995
Steve Ludzik,F,11,0,1,1,-2,1998-2000
Peter Ambroziak,F,12,0,1,1,-1,1998-2004
Terry Ball,D,12,0,1,1,-7,1970-1971
Jason Holland,D,12,0,1,1,-1,1993-1994
Bill Inglis,F,14,0,1,1,-4,2018-2019
Todd Simon,F,15,0,1,1,-3,1990-1992
Remi Elie,F,16,0,1,1,-3,2013-2014
Brian Curran,D,20,0,1,1,-3,1998-2000
Zenon Konopka,F,23,0,1,1,-4,1991-1992
Jean-Luc Grand-Pierre,D,27,0,1,1,-1,1970-1971
Randy Hillier,D,28,0,1,1,-14,2020-2022
Dustin Tokarski,G,36,0,1,1,,1987-1988
Joe Daley,G,38,0,1,1,,2008-2011
Ed Hospodar,D,42,0,1,1,-1,2000-2006
Patrick Lalime,G,47,0,1,1,,2012-2014
Gerry Desjardins,G,116,0,1,1,,1974-1978
Linus Ullmark,G,117,0,1,1,,2015-2021
Jeff Eatough,F,1,0,0,0,-1,1974-1975
Francois Guay,F,1,0,0,0,0,1988-1989
Trent Kaese,F,1,0,0,0,0,2002-2003
Reed Larson,D,1,0,0,0,1,2016-2017
Sean McMorrow,F,1,0,0,0,0,2021-2022
David Moravec,F,1,0,0,0,-1,1989-1990
Brian Perry,F,1,0,0,0,0,2000-2001
Peter Skudra,G,1,0,0,0,,2014-2015
Dean Sylvester,F,1,0,0,0,-1,1981-1982
Joel Armia,F,1,0,0,0,0,2015-2016
Andrei Makarov,G,1,0,0,0,,1989-1990
Dalton Smith,F,1,0,0,0,1,1998-1999
Sean Malone,F,1,0,0,0,0,1999-2000
Adam Wilcox,G,1,0,0,0,,2019-2020
Ryan MacInnis,F,1,0,0,0,0,2021-2022
Jason Kasdorf,G,1,0,0,0,,1970-1971
Christian Wolanin,D,1,0,0,0,-2,2021-2022
Brandon Biro,F,1,0,0,0,0,2014-2015
James Black,F,2,0,0,0,0,2017-2018
Darren Eliot,G,2,0,0,0,,1977-1978
Paul Gardner,F,2,0,0,0,-3,1978-1979
Randy Ireland,G,2,0,0,0,,1985-1986
David Littman,G,2,0,0,0,,1989-1990
Mitch Molloy,F,2,0,0,0,0,2010-2011
Mark Parrish,F,2,0,0,0,-2,1981-1983
Wayne Ramsey,D,2,0,0,0,0,2021-2022
Kai Suikkanen,F,2,0,0,0,0,1993-1994
Doug Trapp,F,2,0,0,0,0,2016-2017
Drew MacIntyre,G,2,0,0,0,,2011-2012
Derek Whitmore,F,2,0,0,0,0,1986-1987
Erik Burgdoerfer,D,2,0,0,0,-1,2011-2012
John Peterka,F,2,0,0,0,0,1990-1992
Jere Gillis,F,3,0,0,0,-6,1988-1989
Jean-Guy Lagace,D,3,0,0,0,0,2017-2018
Bryan McSheffrey,F,3,0,0,0,1,1988-1989
Bob Richer,F,3,0,0,0,0,1982-1983
Steve Smith,D,3,0,0,0,0,1970-1971
Zach Redmond,D,3,0,0,0,1,2017-2019
Danny ORegan,F,3,0,0,0,1,1974-1975
Mike Card,D,4,0,0,0,0,1972-1973
Alex Tidey,F,4,0,0,0,-2,2006-2007
Malcolm Subban,G,4,0,0,0,,2021-2022
Jean-Sebastien Dea,F,4,0,0,0,-1,2019-2020
John Gilmour,D,4,0,0,0,-2,2019-2021
John Blue,G,5,0,0,0,,1976-1978
Peter Ciavaglia,F,5,0,0,0,1,2006-2007
Ty Conklin,G,5,0,0,0,,1995-1998
Richard Hajdu,F,5,0,0,0,2,1985-1987
Mike Hurlbut,D,5,0,0,0,2,1982-1983
Dave McLlwain,F,5,0,0,0,-3,1991-1993
Dean Melanson,D,5,0,0,0,-1,1997-2000
Phil Myre,G,5,0,0,0,,1995-1996
Scott Nichol,F,5,0,0,0,0,2011-2012
Colin Stuart,F,5,0,0,0,-2,1994-1995
Joe Finley,F,5,0,0,0,-3,1991-1992
Brady Austin,D,5,0,0,0,0,2010-2012
Dale Degray,D,6,0,0,0,-4,2016-2017
Paul Harrison,G,6,0,0,0,,1994-1995
Grant Jennings,D,6,0,0,0,1,1981-1982
Jaroslav Kristek,F,6,0,0,0,-2,2008-2009
Robb Stauber,G,6,0,0,0,,2020-2022
Mikael Tellqvist,G,6,0,0,0,,2002-2003
Brandon Davidson,D,6,0,0,0,-4,1995-1996
Michael Houser,G,6,0,0,0,,1989-1990
Val James,F,7,0,0,0,-1,2020-2021
Nathan Lieuwen,G,7,0,0,0,,1981-1982
Bob Essensa,G,9,0,0,0,,2013-2014
Jerry DAmigo,F,9,0,0,0,-4,2017-2018
Kyle Criscuolo,F,9,0,0,0,-4,2014-2015
Doug Janik,D,10,0,0,0,1,2001-2002
Rumun Ndur,D,11,0,0,0,1,2002-2006
Dan Catenacci,F,11,0,0,0,-2,1996-1999
Darcy Loewen,F,12,0,0,0,-7,2015-2016
Brian McDonald,F,12,0,0,0,-8,1970-1971
Mike McMahon,D,12,0,0,0,-9,2007-2008
Jocelyn Thibault,G,12,0,0,0,,1993-1995
Denis Tsygurov,D,12,0,0,0,-2,1989-1992
Aaron Dell,G,12,0,0,0,,1970-1971
Hap Myers,D,13,0,0,0,-10,2021-2022
Matt Hackett,G,13,0,0,0,,2020-2022
Jonas Johansson,G,13,0,0,0,,2013-2015
Ukko-Pekka Luukkonen,G,13,0,0,0,,2019-2021
Radoslav Hecl,D,14,0,0,0,0,1970-1971
William Borgen,D,14,0,0,0,-9,2018-2021
Anders Lindb�ck,G,16,0,0,0,,2002-2003
Jim Hofford,D,17,0,0,0,-2,2014-2015
Joe Noris,D,18,0,0,0,-4,1985-1987
Norm Farr,G,19,0,0,0,,1973-1974
Morris Titanic,F,19,0,0,0,-3,1972-1975
Matt Tennyson,D,19,0,0,0,-12,1974-1976
Al Smith,G,21,0,0,0,,2017-2019
Darcy Wakaluk,G,22,0,0,0,,1975-1977
Craig Anderson,G,24,0,0,0,,1988-1991
Andrei Trefilov,G,25,0,0,0,,1995-1997
Anders Nilsson,G,26,0,0,0,,2016-2017
Michal Neuvirth,G,29,0,0,0,,2021-2022
Steve Shields,G,31,0,0,0,,2013-2015
Dwayne Roloson,G,32,0,0,0,,1995-1998
Jhonas Enroth,G,118,0,0,0,,1998-2000
,,,,,,,2009-2015
